.#####...
.#...####
.#...#..#
.##....g#
###.###g#
#.G.#.#g#
#.GG#.###
#p..#....
#####....