#######
#...g.#
#.#.#.#
#.GpG.#
#.#.#g#
#..s..#
#######