#########
##..p...#
#...G#..#
##.#..g.#
#....#..#
#.##.#g.#
#..G....#
#.......#
#########