.......
######.
#.p..##
#.GG..#
#.#g.g#
#.....#
#######