#######
#....g#
#.G...#
#.###.#
#...p.#
#.#...#
#######