..#####.
###...#.
#.G.#.##
#.#..g.#
#.g..#.#
##G#gG.#
.#p..###
.#####..