#####.
#...##
#gGg.#
#.G#.#
#....#
######