######
#p...#
#....#
#..Gg#
#.gG.#
######