#####.
#.p.##
#gGg.#
#.G#.#
#....#
######