########
#...#..#
#.#.#Gg#
#....Gg#
#.#.#Gg#
#...#..#
#####p.#
....####